
Entidad,Año,Ins_total,Ins_Hombres,Ins_Mujeres,Total,Hombres,Mujeres,%_Total,%_Hombres,%_Mujeres
Nacional,2011,57137285,26284690,30852595,74500383,35474987,39025396,76.7,74.1,79.1
Aguascalientes,2011,512608,225244,287364,759037,351902,407135,67.5,64,70.6
Baja California,2011,1512570,747140,765430,2164168,1123902,1040266,69.9,66.5,73.6
Baja California Sur,2011,194136,85956,108180,446361,231390,214971,43.5,37.1,50.3
Campeche,2011,350134,149357,200777,550282,261808,288474,63.6,57,69.6
Coahuila de Zaragoza,2011,1433187,664750,768437,1837812,911303,926509,78,72.9,82.9
Colima,2011,299834,130327,169507,448217,213175,235042,66.9,61.1,72.1
Chiapas,2011,1795418,797162,998256,2885375,1373719,1511656,62.2,58,66
Chihuahua,2011,1944024,895121,1048903,2299634,1078978,1220656,84.5,83,85.9
Ciudad de México,2011,5843442,2744997,3098445,6548713,3090914,3457799,89.2,88.8,89.6
Durango,2011,833570,391529,442041,1034333,501539,532794,80.6,78.1,83
Guanajuato,2011,2483551,1183236,1300315,3559142,1731240,1827902,69.8,68.3,71.1
Guerrero,2011,1645658,727412,918246,2006414,902430,1103984,82,80.6,83.2
Hidalgo,2011,1226824,530819,696005,1722492,777037,945455,71.2,68.3,73.6
Jalisco,2011,3461544,1529560,1931984,4916191,2310795,2605396,70.4,66.2,74.2
México,2011,9339739,4482935,4856804,10259299,4881566,5377733,91,91.8,90.3
Michoacán de Ocampo,2011,1864107,780944,1083163,2804121,1294301,1509820,66.5,60.3,71.7
Morelos,2011,981141,417585,563556,1186928,531205,655723,82.7,78.6,85.9
Nayarit,2011,515483,231013,284470,722737,351372,371365,71.3,65.7,76.6
Nuevo León,2011,2849762,1341662,1508100,3223956,1554483,1669473,88.4,86.3,90.3
Oaxaca,2011,1596952,744027,852925,2370804,1123705,1247099,67.4,66.2,68.4
Puebla,2011,2748611,1215131,1533480,3600323,1657325,1942998,76.3,73.3,78.9
Querétaro,2011,662346,263750,398596,1218004,537663,680341,54.4,49.1,58.6
Quintana Roo,2011,663852,317696,346156,919193,469202,449991,72.2,67.7,76.9
San Luis Potosí,2011,1227728,583342,644386,1665042,811520,853522,73.7,71.9,75.5
Sinaloa,2011,1484403,690761,793642,1866181,902821,963360,79.5,76.5,82.4
Sonora,2011,1083321,507860,575461,1773735,899706,874029,61.1,56.4,65.8
Tabasco,2011,1218740,606373,612367,1421338,713263,708075,85.7,85,86.5
Tamaulipas,2011,1867762,884637,983125,2221071,1086659,1134412,84.1,81.4,86.7
Tlaxcala,2011,482908,210499,272409,743271,344181,399090,65,61.2,68.3
Veracruz de Ignacio de la Llave,2011,3594809,1608060,1986749,5053704,2390837,2662867,71.1,67.3,74.6
Yucatán,2011,670940,265669,405271,1322438,634843,687595,50.7,41.8,58.9
Zacatecas,2011,748181,330136,418045,950067,430203,519864,78.8,76.7,80.4
Nacional,2012,58466317,26069757,32396560,76228271,35244769,40983502,76.7,74,79
Aguascalientes,2012,449544,193470,256074,798023,374651,423372,56.3,51.6,60.5
Baja California,2012,1542079,717381,824698,2224767,1092660,1132107,69.3,65.7,72.8
Baja California Sur,2012,178071,74337,103734,467211,221542,245669,38.1,33.6,42.2
Campeche,2012,337798,138636,199162,559243,258598,300645,60.4,53.6,66.2
Coahuila de Zaragoza,2012,1509684,730400,779284,1848598,930453,918145,81.7,78.5,84.9
Colima,2012,329879,143990,185889,472509,220539,251970,69.8,65.3,73.8
Chiapas,2012,2039471,873081,1166390,3025658,1366166,1659492,67.4,63.9,70.3
Chihuahua,2012,1960453,880046,1080407,2369080,1108930,1260150,82.8,79.4,85.7
Ciudad de México,2012,6062362,2835790,3226572,6668761,3166906,3501855,90.9,89.5,92.1
Durango,2012,795694,331587,464107,1068751,472722,596029,74.5,70.1,77.9
Guanajuato,2012,2370315,1068874,1301441,3600469,1671157,1929312,65.8,64,67.5
Guerrero,2012,1586270,659859,926411,2077164,888426,1188738,76.4,74.3,77.9
Hidalgo,2012,1197924,481835,716089,1774821,738547,1036274,67.5,65.2,69.1
Jalisco,2012,3617859,1636106,1981753,4998915,2359199,2639716,72.4,69.4,75.1
México,2012,9323011,4241184,5081827,10259275,4725482,5533793,90.9,89.8,91.8
Michoacán de Ocampo,2012,2040502,918016,1122486,2864286,1316466,1547820,71.2,69.7,72.5
Morelos,2012,1035164,467854,567310,1204241,560856,643385,86,83.4,88.2
Nayarit,2012,505570,215863,289707,724097,336735,387362,69.8,64.1,74.8
Nuevo León,2012,2948556,1333047,1615509,3343992,1554267,1789725,88.2,85.8,90.3
Oaxaca,2012,1607689,666773,940916,2458646,1068646,1390000,65.4,62.4,67.7
Puebla,2012,2851388,1217692,1633696,3768734,1663770,2104964,75.7,73.2,77.6
Querétaro,2012,708427,281559,426868,1261039,561114,699925,56.2,50.2,61
Quintana Roo,2012,709888,344506,365382,972601,492155,480446,73,70,76.1
San Luis Potosí,2012,1151672,519730,631942,1698385,802284,896101,67.8,64.8,70.5
Sinaloa,2012,1513004,676324,836680,1861744,885694,976050,81.3,76.4,85.7
Sonora,2012,1140472,518034,622438,1861039,942420,918619,61.3,55,67.8
Tabasco,2012,1283557,599777,683780,1476253,697795,778458,86.9,86,87.8
Tamaulipas,2012,1892380,808801,1083579,2266803,1005747,1261056,83.5,80.4,85.9
Tlaxcala,2012,527174,230729,296445,758279,357353,400926,69.5,64.6,73.9
Veracruz de Ignacio de la Llave,2012,3885271,1719933,2165338,5150852,2342705,2808147,75.4,73.4,77.1
Yucatán,2012,647558,239568,407990,1365296,622623,742673,47.4,38.5,54.9
Zacatecas,2012,717631,304975,412656,978739,438161,540578,73.3,69.6,76.3
Nacional,2013,61413657,27937216,33476441,79027090,37097696,41929394,77.7,75.3,79.8
Aguascalientes,2013,515442,230007,285435,827499,397448,430051,62.3,57.9,66.4
Baja California,2013,1648247,733114,915133,2275576,1076381,1199195,72.4,68.1,76.3
Baja California Sur,2013,199834,90198,109636,494923,251880,243043,40.4,35.8,45.1
Campeche,2013,410041,184323,225718,606073,293258,312815,67.7,62.9,72.2
Coahuila de Zaragoza,2013,1576034,705729,870305,1954341,911817,1042524,80.6,77.4,83.5
Colima,2013,347196,156886,190310,486244,233755,252489,71.4,67.1,75.4
Chiapas,2013,2052756,893607,1159149,3123975,1437051,1686924,65.7,62.2,68.7
Chihuahua,2013,1902204,893757,1008447,2495287,1207632,1287655,76.2,74,78.3
Ciudad de México,2013,5945606,2910454,3035152,6664266,3347618,3316648,89.2,86.9,91.5
Durango,2013,783552,341533,442019,1123794,515602,608192,69.7,66.2,72.7
Guanajuato,2013,2774360,1243691,1530669,3742878,1688421,2054457,74.1,73.7,74.5
Guerrero,2013,1746980,774697,972283,2139666,947512,1192154,81.6,81.8,81.6
Hidalgo,2013,1251723,531737,719986,1841722,837153,1004569,68,63.5,71.7
Jalisco,2013,3939438,1774807,2164631,5216434,2470256,2746178,75.5,71.8,78.8
México,2013,10246331,4839562,5406769,10943451,5136471,5806980,93.6,94.2,93.1
Michoacán de Ocampo,2013,2057526,880644,1176882,2910364,1306582,1603782,70.7,67.4,73.4
Morelos,2013,1096577,517140,579437,1249257,600331,648926,87.8,86.1,89.3
Nayarit,2013,445656,186419,259237,770633,362906,407727,57.8,51.4,63.6
Nuevo León,2013,2883299,1345098,1538201,3482301,1658410,1823891,82.8,81.1,84.3
Oaxaca,2013,1734973,717731,1017242,2538774,1111723,1427051,68.3,64.6,71.3
Puebla,2013,3042827,1306062,1736765,3869810,1739371,2130439,78.6,75.1,81.5
Querétaro,2013,740944,311065,429879,1266266,578317,687949,58.5,53.8,62.5
Quintana Roo,2013,766292,355079,411213,1009715,491569,518146,75.9,72.2,79.4
San Luis Potosí,2013,1259921,559688,700233,1746166,815251,930915,72.2,68.7,75.2
Sinaloa,2013,1583370,724771,858599,1999213,971949,1027264,79.2,74.6,83.6
Sonora,2013,1177661,520700,656961,1910297,937153,973144,61.6,55.6,67.5
Tabasco,2013,1355491,657846,697645,1517936,755263,762673,89.3,87.1,91.5
Tamaulipas,2013,1837809,826653,1011156,2349835,1074170,1275665,78.2,77,79.3
Tlaxcala,2013,571628,254368,317260,797688,369278,428410,71.7,68.9,74.1
Veracruz de Ignacio de la Llave,2013,4008424,1824019,2184405,5267140,2453117,2814023,76.1,74.4,77.6
Yucatán,2013,754358,315594,438764,1421180,679282,741898,53.1,46.5,59.1
Zacatecas,2013,757157,330237,426920,984386,440769,543617,76.9,74.9,78.5
Nacional,2014,62137093,27761771,34375322,79613925,37028535,42585390,78,75,80.7
Aguascalientes,2014,516865,239824,277041,830115,402466,427649,62.3,59.6,64.8
Baja California,2014,1692583,780700,911883,2285025,1105378,1179647,74.1,70.6,77.3
Baja California Sur,2014,250209,108377,141832,497268,252757,244511,50.3,42.9,58
Campeche,2014,411396,179751,231645,597703,283624,314079,68.8,63.4,73.8
Coahuila de Zaragoza,2014,1485271,660098,825173,1910550,887092,1023458,77.7,74.4,80.6
Colima,2014,310031,128426,181605,490590,226482,264108,63.2,56.7,68.8
Chiapas,2014,2119479,885916,1233563,3109939,1388039,1721900,68.2,63.8,71.6
Chihuahua,2014,1801109,821089,980020,2368009,1130032,1237977,76.1,72.7,79.2
Ciudad de México,2014,5968163,2593291,3374872,6725007,3001287,3723720,88.7,86.4,90.6
Durango,2014,830110,327030,503080,1126212,484262,641950,73.7,67.5,78.4
Guanajuato,2014,2716639,1107294,1609345,3695098,1618155,2076943,73.5,68.4,77.5
Guerrero,2014,1682619,746980,935639,2177517,991508,1186009,77.3,75.3,78.9
Hidalgo,2014,1301584,558713,742871,1883513,853000,1030513,69.1,65.5,72.1
Jalisco,2014,3804273,1588022,2216251,5192251,2349170,2843081,73.3,67.6,78
México,2014,10513162,5180270,5332892,11184994,5479277,5705717,94,94.5,93.5
Michoacán de Ocampo,2014,2131298,944262,1187036,2929255,1350756,1578499,72.8,69.9,75.2
Morelos,2014,1161857,563965,597892,1310351,639790,670561,88.7,88.1,89.2
Nayarit,2014,442494,178305,264189,795462,360215,435247,55.6,49.5,60.7
Nuevo León,2014,2797489,1338965,1458524,3461927,1712458,1749469,80.8,78.2,83.4
Oaxaca,2014,1959361,864322,1095039,2599628,1227507,1372121,75.4,70.4,79.8
Puebla,2014,3090770,1326340,1764430,3943835,1789580,2154255,78.4,74.1,81.9
Querétaro,2014,792943,343837,449106,1294794,604290,690504,61.2,56.9,65
Quintana Roo,2014,780661,342339,438322,1006462,460849,545613,77.6,74.3,80.3
San Luis Potosí,2014,1247921,537166,710755,1760397,782313,978084,70.9,68.7,72.7
Sinaloa,2014,1455336,601355,853981,1991590,919477,1072113,73.1,65.4,79.7
Sonora,2014,1234401,547617,686784,1919739,942512,977227,64.3,58.1,70.3
Tabasco,2014,1365603,611473,754130,1528812,698090,830722,89.3,87.6,90.8
Tamaulipas,2014,1942495,867143,1075352,2370221,1078536,1291685,82,80.4,83.3
Tlaxcala,2014,613118,258640,354478,818086,368563,449523,74.9,70.2,78.9
Veracruz de Ignacio de la Llave,2014,4202948,1881929,2321019,5373638,2476221,2897417,78.2,76,80.1
Yucatán,2014,777835,322847,454988,1434836,699287,735549,54.2,46.2,61.9
Zacatecas,2014,737070,325485,411585,1001101,465562,535539,73.6,69.9,76.9
Nacional,2015,63374880,28250845,35124035,80913163,37653398,43259765,78.3,75,81.2
Aguascalientes,2015,499096,198054,301042,826776,369642,457134,60.4,53.6,65.9
Baja California,2015,1754061,779423,974638,2324817,1113660,1211157,75.4,70,80.5
Baja California Sur,2015,339675,159233,180442,513401,257991,255410,66.2,61.7,70.6
Campeche,2015,406968,180596,226372,609644,297734,311910,66.8,60.7,72.6
Coahuila de Zaragoza,2015,1499630,653970,845660,1931814,886923,1044891,77.6,73.7,80.9
Colima,2015,306705,122887,183818,495710,230834,264876,61.9,53.2,69.4
Chiapas,2015,2222071,958051,1264020,3171336,1441399,1729937,70.1,66.5,73.1
Chihuahua,2015,1737312,804388,932924,2452925,1187767,1265158,70.8,67.7,73.7
Ciudad de México,2015,6353276,2912845,3440431,6885392,3180423,3704969,92.3,91.6,92.9
Durango,2015,769052,331028,438024,1145726,527341,618385,67.1,62.8,70.8
Guanajuato,2015,2832790,1219412,1613378,3683034,1680454,2002580,76.9,72.6,80.6
Guerrero,2015,1749775,763655,986120,2218531,992417,1226114,78.9,76.9,80.4
Hidalgo,2015,1386231,630479,755752,1927642,929962,997680,71.9,67.8,75.8
Jalisco,2015,4051115,1771561,2279554,5261794,2455096,2806698,77,72.2,81.2
México,2015,10612834,4901428,5711406,11458236,5386312,6071924,92.6,91,94.1
Michoacán de Ocampo,2015,2094242,879134,1215108,3015726,1339805,1675921,69.4,65.6,72.5
Morelos,2015,1174836,545736,629100,1319461,613809,705652,89,88.9,89.2
Nayarit,2015,448336,197822,250514,815389,406378,409011,55,48.7,61.2
Nuevo León,2015,2904902,1334858,1570044,3519863,1705776,1814087,82.5,78.3,86.5
Oaxaca,2015,1922083,838616,1083467,2586646,1163266,1423380,74.3,72.1,76.1
Puebla,2015,3075333,1316024,1759309,3943603,1767889,2175714,78,74.4,80.9
Querétaro,2015,894912,378354,516558,1335421,614109,721312,67,61.6,71.6
Quintana Roo,2015,796350,338395,457955,1034056,461174,572882,77,73.4,79.9
San Luis Potosí,2015,1225598,530168,695430,1774437,817424,957013,69.1,64.9,72.7
Sinaloa,2015,1446082,583936,862146,2000620,911641,1088979,72.3,64.1,79.2
Sonora,2015,1328050,632946,695104,1973052,970656,1002396,67.3,65.2,69.3
Tabasco,2015,1407954,636633,771321,1558732,716488,842244,90.3,88.9,91.6
Tamaulipas,2015,1875598,859830,1015768,2405118,1129458,1275660,78,76.1,79.6
Tlaxcala,2015,623569,268198,355371,834657,381973,452684,74.7,70.2,78.5
Veracruz de Ignacio de la Llave,2015,4115578,1864943,2250635,5472670,2585455,2887215,75.2,72.1,78
Yucatán,2015,808122,338582,469540,1424466,679176,745290,56.7,49.9,63
Zacatecas,2015,712744,319660,393084,992468,450966,541502,71.8,70.9,72.6
Nacional,2016,64628788,29185562,35443226,82565384,38568067,43997317,78.3,75.7,80.6
Aguascalientes,2016,547280,228294,318986,843788,392639,451149,64.9,58.1,70.7
Baja California,2016,1811568,792800,1018768,2417854,1136484,1281370,74.9,69.8,79.5
Baja California Sur,2016,323026,153688,169338,539742,276036,263706,59.8,55.7,64.2
Campeche,2016,432011,200739,231272,622864,309920,312944,69.4,64.8,73.9
Coahuila de Zaragoza,2016,1297033,592059,704974,1960866,955813,1005053,66.1,61.9,70.1
Colima,2016,375282,161583,213699,505836,233167,272669,74.2,69.3,78.4
Chiapas,2016,2253592,1038332,1215260,3207922,1536519,1671403,70.3,67.6,72.7
Chihuahua,2016,1652202,792001,860201,2529903,1269818,1260085,65.3,62.4,68.3
Ciudad de México,2016,6110435,2775320,3335115,6805124,3100534,3704590,89.8,89.5,90
Durango,2016,744146,335811,408335,1162319,556249,606070,64,60.4,67.4
Guanajuato,2016,2965493,1339135,1626358,3859532,1743398,2116134,76.8,76.8,76.9
Guerrero,2016,1813678,824600,989078,2273493,1050310,1223183,79.8,78.5,80.9
Hidalgo,2016,1377513,583837,793676,1931600,866185,1065415,71.3,67.4,74.5
Jalisco,2016,4038333,1832637,2205696,5370491,2571451,2799040,75.2,71.3,78.8
México,2016,11085175,5251190,5833985,11698207,5517551,6180656,94.8,95.2,94.4
Michoacán de Ocampo,2016,1933335,816695,1116640,3111957,1421393,1690564,62.1,57.5,66.1
Morelos,2016,1159071,515949,643122,1344344,619263,725081,86.2,83.3,88.7
Nayarit,2016,409403,166346,243057,833547,400129,433418,49.1,41.6,56.1
Nuevo León,2016,2966546,1334603,1631943,3579298,1675956,1903342,82.9,79.6,85.7
Oaxaca,2016,1959575,864827,1094748,2655574,1219152,1436422,73.8,70.9,76.2
Puebla,2016,3401238,1536063,1865175,4104708,1889880,2214828,82.9,81.3,84.2
Querétaro,2016,995392,446568,548824,1365684,648790,716894,72.9,68.8,76.6
Quintana Roo,2016,838686,387634,451052,1094796,522071,572725,76.6,74.2,78.8
San Luis Potosí,2016,1234933,519398,715535,1826071,817025,1009046,67.6,63.6,70.9
Sinaloa,2016,1396365,608021,788344,2030436,970835,1059601,68.8,62.6,74.4
Sonora,2016,1349250,577182,772068,1999857,934645,1065212,67.5,61.8,72.5
Tabasco,2016,1438811,661723,777088,1573096,734561,838535,91.5,90.1,92.7
Tamaulipas,2016,2043287,919372,1123915,2446787,1137289,1309498,83.5,80.8,85.8
Tlaxcala,2016,643955,273661,370294,853298,388649,464649,75.5,70.4,79.7
Veracruz de Ignacio de la Llave,2016,4435851,1956522,2479329,5538448,2500999,3037449,80.1,78.2,81.6
Yucatán,2016,866168,364565,501603,1469414,688706,780708,58.9,52.9,64.2
Zacatecas,2016,730155,334407,395748,1008528,482650,525878,72.4,69.3,75.3
Nacional,2017,66500562,29937150,36563412,83888403,39329338,44559065,79.3,76.1,82.1
Aguascalientes,2017,575219,250279,324940,864324,411696,452628,66.6,60.8,71.8
Baja California,2017,1813590,834382,979208,2440700,1213843,1226857,74.3,68.7,79.8
Baja California Sur,2017,381061,181230,199831,561125,284150,276975,67.9,63.8,72.1
Campeche,2017,466983,202822,264161,637456,308469,328987,73.3,65.8,80.3
Coahuila de Zaragoza,2017,1312292,584543,727749,2039213,986179,1053034,64.4,59.3,69.1
Colima,2017,383802,156416,227386,519563,236482,283081,73.9,66.1,80.3
Chiapas,2017,2355538,1023740,1331798,3265247,1495750,1769497,72.1,68.4,75.3
Chihuahua,2017,1800812,843766,957046,2545863,1259165,1286698,70.7,67,74.4
Ciudad de México,2017,6422880,2994819,3428061,6903830,3239022,3664808,93,92.5,93.5
Durango,2017,753142,332882,420260,1178682,568708,609974,63.9,58.5,68.9
Guanajuato,2017,3180319,1434312,1746007,3858134,1787377,2070757,82.4,80.2,84.3
Guerrero,2017,1837396,812490,1024906,2285293,1057907,1227386,80.4,76.8,83.5
Hidalgo,2017,1424149,598986,825163,1960305,874588,1085717,72.6,68.5,76
Jalisco,2017,4102496,1891595,2210901,5519573,2633332,2886241,74.3,71.8,76.6
México,2017,11302394,5253151,6049243,11939576,5623194,6316382,94.7,93.4,95.8
Michoacán de Ocampo,2017,2120670,894780,1225890,3087072,1373771,1713301,68.7,65.1,71.6
Morelos,2017,1188736,525439,663297,1360977,619019,741958,87.3,84.9,89.4
Nayarit,2017,453425,189383,264042,852214,402075,450139,53.2,47.1,58.7
Nuevo León,2017,2829079,1272151,1556928,3625360,1718398,1906962,78,74,81.6
Oaxaca,2017,2011086,885557,1125529,2675674,1249987,1425687,75.2,70.8,78.9
Puebla,2017,3393380,1528170,1865210,4150833,1910204,2240629,81.8,80,83.2
Querétaro,2017,974866,423952,550914,1390035,643450,746585,70.1,65.9,73.8
Quintana Roo,2017,874608,402266,472342,1125203,541328,583875,77.7,74.3,80.9
San Luis Potosí,2017,1256245,513323,742922,1857886,842213,1015673,67.6,60.9,73.1
Sinaloa,2017,1525267,671206,854061,2091794,1003440,1088354,72.9,66.9,78.5
Sonora,2017,1450857,636408,814449,2033340,954311,1079029,71.4,66.7,75.5
Tabasco,2017,1504464,683470,820994,1626476,756144,870332,92.5,90.4,94.3
Tamaulipas,2017,1933217,883212,1050005,2466039,1161378,1304661,78.4,76,80.5
Tlaxcala,2017,673190,294815,378375,866087,402438,463649,77.7,73.3,81.6
Veracruz de Ignacio de la Llave,2017,4572368,2024299,2548069,5607157,2562464,3044693,81.5,79,83.7
Yucatán,2017,865837,362925,502912,1509142,710217,798925,57.4,51.1,62.9
Zacatecas,2017,761194,350381,410813,1044230,498639,545591,72.9,70.3,75.3
Nacional,2018,68629524,30862895,37766629,85382288,39882102,45500186,80.4,77.4,83
Aguascalientes,2018,649996,277427,372569,882617,402551,480066,73.6,68.9,77.6
Baja California,2018,2036222,913411,1122811,2492363,1196836,1295527,81.7,76.3,86.7
Baja California Sur,2018,379943,165522,214421,583025,284894,298131,65.2,58.1,71.9
Campeche,2018,443564,200318,243246,639919,314092,325827,69.3,63.8,74.7
Coahuila de Zaragoza,2018,1316468,556002,760466,2045238,953075,1092163,64.4,58.3,69.6
Colima,2018,409738,179723,230015,526858,249380,277478,77.8,72.1,82.9
Chiapas,2018,2455104,1106950,1348154,3338948,1547187,1791761,73.5,71.5,75.2
Chihuahua,2018,1882126,858902,1023224,2577485,1233789,1343696,73,69.6,76.1
Ciudad de México,2018,6424941,2933093,3491848,6875376,3149904,3725472,93.4,93.1,93.7
Durango,2018,739810,326949,412861,1192020,566964,625056,62.1,57.7,66.1
Guanajuato,2018,3247785,1444716,1803069,3906269,1786667,2119602,83.1,80.9,85.1
Guerrero,2018,1916311,816461,1099850,2367550,1063927,1303623,80.9,76.7,84.4
Hidalgo,2018,1491524,624248,867276,1989592,879736,1109856,75,71,78.1
Jalisco,2018,4280773,1910629,2370144,5665539,2664913,3000626,75.6,71.7,79
México,2018,11431593,5352439,6079154,12214456,5740071,6474385,93.6,93.2,93.9
Michoacán de Ocampo,2018,2143176,900807,1242369,3143294,1448935,1694359,68.2,62.2,73.3
Morelos,2018,1207425,579740,627685,1390031,682967,707064,86.9,84.9,88.8
Nayarit,2018,628417,271630,356787,885909,417976,467933,70.9,65,76.2
Nuevo León,2018,3053823,1432589,1621234,3748664,1820120,1928544,81.5,78.7,84.1
Oaxaca,2018,2061214,940947,1120267,2726606,1288267,1438339,75.6,73,77.9
Puebla,2018,3609969,1617369,1992600,4216698,1912365,2304333,85.6,84.6,86.5
Querétaro,2018,1029335,411566,617769,1418555,625592,792963,72.6,65.8,77.9
Quintana Roo,2018,928044,436795,491249,1173123,580964,592159,79.1,75.2,83
San Luis Potosí,2018,1447541,592792,854749,1891500,829793,1061707,76.5,71.4,80.5
Sinaloa,2018,1475601,640780,834821,2105408,1000631,1104777,70.1,64,75.6
Sonora,2018,1507632,649339,858293,2077428,959254,1118174,72.6,67.7,76.8
Tabasco,2018,1501825,685901,815924,1628394,760612,867782,92.2,90.2,94
Tamaulipas,2018,1983695,861721,1121974,2517234,1151666,1365568,78.8,74.8,82.2
Tlaxcala,2018,754326,332913,421413,902405,417019,485386,83.6,79.8,86.8
Veracruz de Ignacio de la Llave,2018,4520490,2069097,2451393,5663341,2664787,2998554,79.8,77.6,81.8
Yucatán,2018,878443,371391,507052,1542235,751224,791011,57,49.4,64.1
Zacatecas,2018,792670,400728,391942,1054208,535944,518264,75.2,74.8,75.6
Nacional,2019,68703187,30700740,38002447,87378633,41044318,46334315,78.6,74.8,82
Aguascalientes,2019,605896,248031,357865,900134,408519,491615,67.3,60.7,72.8
Baja California,2019,2008934,895856,1113078,2572292,1228409,1343883,78.1,72.9,82.8
Baja California Sur,2019,348148,166700,181448,598671,313123,285548,58.2,53.2,63.5
Campeche,2019,456873,208777,248096,666845,334870,331975,68.5,62.3,74.7
Chiapas,2019,1270082,529796,740286,2120634,1016645,1103989,59.9,52.1,67.1
Chihuahua,2019,406843,178599,228244,549222,264473,284749,74.1,67.5,80.2
Ciudad de Mexico,2019,2505973,1107963,1398010,3371367,1529972,1841395,74.3,72.4,75.9
Coahuila de Zaragoza,2019,1806829,768498,1038331,2658297,1274571,1383726,68,60.3,75
Colima,2019,6463186,2949886,3513300,6929236,3169245,3759991,93.3,93.1,93.4
Durango,2019,755239,323388,431851,1232357,584110,648247,61.3,55.4,66.6
Guanajuato,2019,3424684,1502019,1922665,4052557,1852418,2200139,84.5,81.1,87.4
Guerrero,2019,1795865,794463,1001402,2391434,1091869,1299565,75.1,72.8,77.1
Hidalgo,2019,1479235,632535,846700,2046253,937051,1109202,72.3,67.5,76.3
Jalisco,2019,4219210,1840780,2378430,5630901,2682288,2948613,74.9,68.6,80.7
Mexico,2019,11674810,5605560,6069250,12741383,6079697,6661686,91.6,92.2,91.1
Michoacan de Ocampo,2019,2295656,990434,1305222,3198824,1481614,1717210,71.8,66.8,76
Morelos,2019,1230497,536033,694464,1421074,642573,778501,86.6,83.4,89.2
Nayarit,2019,508341,193622,314719,891394,422083,469311,57,45.9,67.1
Nuevo Leon,2019,3057478,1399756,1657722,3860645,1877373,1983272,79.2,74.6,83.6
Oaxaca,2019,1954122,820818,1133304,2721492,1212728,1508764,71.8,67.7,75.1
Puebla,2019,3878780,1800077,2078703,4344596,2053241,2291355,89.3,87.7,90.7
Queretaro,2019,1034601,419374,615227,1469579,661248,808331,70.4,63.4,76.1
Quintana Roo,2019,1001483,485044,516439,1215033,604924,610109,82.4,80.2,84.6
San Luis Potosi,2019,1377361,583321,794040,1940211,889636,1050575,71,65.6,75.6
Sinaloa,2019,1387613,579760,807853,2118593,1008648,1109945,65.5,57.5,72.8
Sonora,2019,1443586,602261,841325,2152667,1055740,1096927,67.1,57,76.7
Tabasco,2019,1518955,686848,832107,1665534,770883,894651,91.2,89.1,93
Tamaulipas,2019,1864861,807054,1057807,2586915,1200091,1386824,72.1,67.2,76.3
Tlaxcala,2019,724043,313009,411034,907104,419298,487806,79.8,74.7,84.3
Veracruz de Ignacio de la Llave,2019,4584421,2038644,2545777,5756308,2715529,3040779,79.6,75.1,83.7
Yucatan,2019,870851,350193,520658,1595059,749662,845397,54.6,46.7,61.6
Zacatecas,2019,748731,341641,407090,1072022,511787,560235,69.8,66.8,72.7
